00000000330001111110003300000000
00220000000001111110000000002200
00220002200001111110000220002200
00000002200001111110000220000000
00000000000001111110000000000000
11111100000001111110000000111111
11111100000000000000000000111111
11111100003300000000330000111111
11111100003300000000330000111111
11111100000000000000000000111111
11111100000001111110000000111111
00000000000001111110000000000000
00000002200001111110000220000000
00220002200001111110000220002200
00220000000001111110000000002200
00000000330001111110003300000000