00001100000000000000000000110000
00001100000000000000000000110000
00000000000000000000000000000000
00000000000000000000000000000000
22000000110000000000001100000022
22000000110000033000001100000022
00000000000003333330000000000000
00000000000333333333300000000000
00000000000003333330000000000000
00000000000000033000000000000000
22000000110000000000001100000022
22000000110000000000001100000022
00000000000000000000000000000000
00000000000000000000000000000000
00001100000000000000000000110000
00001100000000000000000000110000