################################
#000000111111111111111111000000#
#555000111111111111111111000555#
#555000111111111111111111000555#
#555000111111111111111111000555#
#000000111111111111111111000000#
#000000111111111111111111000000#
#000000111111111111111111000000#
#000000111111111111111111000000#
#000000000044444444400000000000#
#222000000044444444400000000222#
#222000000044000004400000000222#
#222000000044000004400000000222#
#222222220044000004400022222222#
#222222220066000007700022222222#
################################