################################
#022000000000111111000000000220#
#022000220000111111000022000220#
#000000220000111111000022000000#
#000000000000111111000000000000#
#111110000000111111000000011111#
#111110000000000000000000011111#
#111110000330000000033000011111#
#111110000330000000033000011111#
#111110000000000000000000011111#
#111110000000111111000000011111#
#000000000000111111000000000000#
#000000220000111111000022000000#
#066000220000111111000022000660#
#066000000000111111000000000660#
################################