################################
#000111001110001100011100111000#
#000111001110001100011100111000#
#000111001110001100011100111000#
#000000000000000000000000000000#
#000000000000000000000000000000#
#222220000033333333330000022222#
#222220000033333333330000022222#
#222220000033333333330000022222#
#222220000033333333330000022222#
#222220000033333333330000022222#
#000000000000000000000000000000#
#000000000000000000000000000000#
#666000000022222222220000000777#
#666000000022222222220000000777#
################################