################################
#000011000000000000000000110000#
#000011000000000000000000110000#
#222000000000003300000000000222#
#222000011000033330000110000222#
#222000011000333333000110000222#
#222000000003333333300000000222#
#000000000033333333330000000000#
#000000000003333333300000000000#
#222000000000333333000000000222#
#222000011000033330000110000222#
#222000011000003300000110000222#
#222000000000000000000000000222#
#000066000000000000000000770000#
#000066000000000000000000770000#
################################