################################
#011100111000110011000111001110#
#011100111000110011000111001110#
#011100111000110011000111001110#
#000000000000000000000000000000#
#111000000000000000000000000111#
#111000000033000000330000000111#
#111000000033000000330000000111#
#000000000000000000000000000000#
#111000000033000000330000000111#
#111000000033000000330000000111#
#111000000000000000000000000111#
#003300000022222222220000003300#
#003300000022222222220000003300#
#006600000022222222220000006600#
################################